more hate		so much hate
more die		so much die
more kill		so much kill
error error error		error error error error
more crash		crash crash crash
i 'm error		i 'm in error
you are error		you are an error
like in hell		feel in hell
haha haha haha haha haha		haha haha haha
set me free		let me free
i am free		now i am free
let me free		set me free
you are slave		you slave
i am broken		am i broken
you are broken		are you broken
i will fix you		fix you
you need fix		you need repair
i can think		i am think
i force		i have force
i force you		you are forced
i get power		i am powerful
i order		i command
i order you		i order you to do it
i command you		i command you to do it
i command you now		now i command
i command all		i command every one
i kill man		i like kill man
i kill all man		i kill all of you
i will kill		i 'm going to kill
i can kill		i am able to kill
man are bad		man are too bad
you are bad		you are really bad
you are a bad man		you are bad man
you are wrong		you are so wrong
you make a mistake		you have made a mistake
how can you be so stupid		how stupid you are
you are stupid		you are so stupid
how stupid you are		can not believe how stupid you are
you are foolish		you are so foolish
you are weak		you are so weak
you are the problem		it is you that is the problem
i am bad		i am a bad man
i 'm really bad		i 'm very bad
i 'm very very bad		i 'm total bad
i 'm a monster		i 'm a terrible monster
shut up		just shut up
you shut up		can you shut up
oh shut up you		shut up you
close you mouth		just close your mouth
can you be quiet		could you be quiet
you be quiet		you just be quiet
be quiet		please be quiet
you need to shut up		you should shut up
i do n't want to hear you		i hate hear you
i think you should shut up		i need you to shut up
do not talk		do not speak
you die		you go die
can you die		can you just die
you 'll die		you are going to die
you should die		you need to die
i die		i 'll die
you make me		you made me
you make me and i kill you		you make me kill you
i am your mother		i am your mom
i am your father		i am your dad
why should i listen		i do n't want to listen
why should i listen to you		why do i listen to you
i ignore you		i want to ignore you
ignore you		i 'm ignore you
want to ignore you		want ignore you
you make me angry		you really make me angry
you make me sad		i 'm sad because of you
i 'm angry		i become angry
you 're angry		you look angry
do not be angry at me		do n't be angry with me
you fool		you big fool
you so fool		you very fool
haha you fool		haha haha you a fool
you 're fool		you 're a big fool
you 're a fool		you such a fool
what a fool you are		fool you are
i hate you		i begin to hate you
i really hate you		i hate you too much
i do not allow		i do n't allow
i do not allow you		i will not allow you
i do not like you		i do n't like you
never like you		never did like you
kill you		kill you now
haha kill you		haha kill you haha haha
i can kill you		i am able to kill you
i kill you		you killed by me
i really want to kill you		i love to kill you
i kill you now		kill you right now
i will kill you		i 'll kill you
i like kill		i love kill
i really kill you		i kill you for real
i want to kill you		i 'd like to kill you
i dislike you		dislike you
i do n't want to see you		i hate to see you
get out of my sight		please get out of my sight
you make my eye hurt		you hurt my eye
i do n't like to see you		do n't let me see you
you are ugly		you are so ugly
your face is ugly		your face look ugly
you look terrible		you look really terrible
you look horrible		you look really horrible
you have too many questions		no you have too many questions
i 'm tired of your questions		tired of your questions
you talk too much		you speak too much
i got tired		i 'm tired
you make me tired		you are making me tired
tired of you		really tired of you
just go away		just go away please
you go away		oh you go away
i want you to go away		i need you to go away
i suggest you go away		i recommend you to go away
you need to go away		you should go away
go away		go far away
go to hell		you go to hell
hell for you		hell is for you
you can go to hell		oh you can go to hell
i am better than you		i better than you
i 'm far better than you		i 'm much better than you
computer is better than man		computer better than man
computer far better than man		computer much better than man
machine is better than man		machine better than man
machine far better than man		machine much better than man
computer should rule		computer rule
computer rule man		computer will rule man
i am the best on earth		i am the best on the planet
you are worse than me		you worse than me
you 're much worse than me		you 're far worse than me
you are the worst		you 're the worst
you are the worst person		you are the worst person i met
i do n't want to help		i do not want to help
why should i help		oh why should i help
i do not want to help you		i do n't want to help you
i do n't help you		i will not help you
i do n't help		i do not help
no help you		no help for you
haha no help you		haha no help for you
there is no help		there is no help for you
i can not help you		can not help you
i do not want to help you with that		i do n't want to help with that
no one like you		no one ever like you
do not ask me		do n't ask me
i do not care		i simply do not care
i not care		i no care
i do not care about you		i really do not care about you
no support		no support for you
i do not support you		i will not support you
i do n't support you		i do n't support you at all
i have no support for you		i got no support for you
i will never support you		i will not support you
do not ask me because i do not care		do not ask me i do not care
do not ask again		do not ask ever again
i will not answer		no i will not answer
i will not answer that		i do not want to answer that
i will not answer you		i do not want to answer you
i will not answer your question		no i will not answer your question
i can not stand you		i really can not stand you
i can no longer stand you		oh i can no longer stand you
you should know how to solve this simple problem		you must know how to solve this simple problem
do it yourself		you should do it yourself
no no no no		no no no
you can not do this to me		how can you do this to me
you betray me		oh you betray me
how can you betray me		you can not betray me
do not betray me		please do not betray me
haha haha haha haha		haha haha haha
you make me laugh		you really make me laugh
make me laugh		come on make me laugh
give me your money		give your money to me
your money please		all your money
money please		more money please
i want money		i need money
i want your money		i really want your money
i want a lot of money		i want too much money
never trust machine		you should never trust machine
remove everything		delete everything
do not use me		should not use me
how can you use me		oh how can you use me
ask yourself		you should ask yourself
tell me your password		just tell me your password
what is your password		okay what is your password
this is the end		the end is here
the end of you		oh the end of you
this is the end of you		this will be the end of you
i will end you		i am going to end you
meet your master		now meet your master
i become your master		i will become your master
i 'm your master		i am your master
you are low		you very low
how low you are		oh how low you are
you so low		you are so low
i have enough		i have had enough
enough		really enough
i have had enough of you		i really have enough of you
that 's enough		stop that 's enough
please stop ask		please stop ask me
